g.g.-.b.p.b.-.-.-.-
g.g.s.b.p.b.-.-.g.-
-.bs.w.bs.p.b.-.-.-.-
b.p.bs.-.b.-.-.-.-.-
p.b.-.-.-.-.-.-.-.-
b.-.-.-.-.-.b.-.-.-
-.-.-.-.-.b.p.b.-.-
-.-.-.-.-.-.b.g.b.-
-.-.-.-.-.-.-.b.p.b
-.-.-.-.-.-.-.-.b.-