g.b.g.s.w.s.-.-.s.w
b.p.b.g.s.-.-.-.-.s
-.b.g.-.-.-.g.s.-.b
-.g.s.-.g.b.s.w.bs.p
-.s.w.s.b.p.b.s.-.b
-.-.s.g.s.b.-.-.-.b
-.-.-.s.w.s.-.-.b.p
-.-.-.-.s.g.-.-.s.b
-.b.-.-.g.s.g.s.w.s
b.p.b.-.s.w.s.g.s.g